@@@@@@@@@@@@@@@ @@@@@@@@@@@@@
@@@@@@@@@       @@@@@@@
@@@@@@@@@ @@@ @@@@@@    @@@@@
@@@       @@@ @@@@@@ @@@@@@@@
@@@@ @@@@@@@@ @@@@@@     @@@@
  @@ @@@      @@@@@@ @@@ @@@@
@        @@@@        @@@ @@@@
@@@@@@@@@@@@@@@@@@@@@@@@ @@@@    